1111111111111111111111111111111111111
1000000020000000011100000000200000001
1000000020000000011100000000200000001
1000000020000000011100000000200000001
1111111111112222111112222111111111111
1000000000000000001000000000000000001
1000000000000000002000000000000000001
1000000000000000001000000000000000001
1111111222111111111111111112221111111
0000000000000003333333000000000000000
0000000000000003333333000000000000000
1111111222111111111111111112221111111
1000000000000000001000000000000000001
1000000000000000002000000000000000001
1000000000000000001000000000000000001
1111111111111222111112222111111111111
1000000020000000011100000000200000001
1000000020000000011100000000200000001
1000000020000000011100000000200000001
1111111111111111111111111111111111111
