1111111111111111111111111111111111111
1000000000000003332333000000000000001
1000000000000003332333000000000000001
1000000000333333332333333330000000001
1000000000333333332333333330000000001
1000000000330203332333020330000000001
1000000000330203332333020330000000001
1444442222224444442444444222222444441
1000000000000000002000000000000000001
1000000000000000002000000000000000001
1000000000000000002000000000000000001
1000000000000000002000000000000000001
1444442222224444442444444222222444441
1000000000000003332333000000000000001
1000000000000003332333000000000000001
1000000000333333332333333330000000001
1000000000333333332333333330000000001
1000000000330203332333020330000000001
1000000000330203332333020330000000001
1111111111111111111111111111111111111
